N N N N N N N N N N N N N N N N N N N N N N N N N N N N N N N N N N N N N N N N N N N N N N N N N N N N N N N N N N N N N N N N N N N N N N N N N N N N N N N N N N N N N N N N N N N N N N N N
N N N N N N N N N N N N N N N N N N N N N N N N N N N N N N N N N N N N N N N N N N N N N N N N N N N N N N N N N N N N N N N N N N N N N N N N N N N N N N N N N N N N N N N N N N N N N N N N
N N N N N N N N N N N N N N N N N N N N N N N N N N N N N N N N N N N N N N N N N N N N N N N N N N N N N N N N N N N N N N N P P N N N N N N N N N N N N N N N N N N N N N N N N N N N N N N N
N N N N N N N N N N N N N N N L L L L N N N N N N N N N N N N N N N N N N N N N N N N N N N N N N N N N N N N N N N N N N N N N N N N N N N N N N N N N N N N N N N N N N N N N N N N N N N N N
N N N N N N N N N N N N L L L l l l l L L N N N N N N N N N N N N N N N N N N N N N N N N N N N N N N N N N N N N N N N N N N N N N N N N N N N N N N N N N N N N N N N N N N N N N N N N N N N
N N N N N N N N N N N L l l l l l l l l l L N N N N N N N N N N N N N N N N N N N N N N N N N N N N N N N N N N N N N N N N N N N N N N N N N N N P P N N N N N N N N N N N N N N N N N N N N N
N N N N N N N N N N L l l l l l l l l l l l N N N N N N N N N N N N N N N N N N N N N N N N N N N N N N N N N N N N N N N N N N N N N N N P P N N N N N N S S S S N N N N N N N N N N N N N N N
N N N N N N N N N N N l l l l l l l l l l l N N N N N N N N N N N N N N N N N N N N N N N N N N N N N N N N N N N N N N N N N N N N N N N N N N N N N N S s s s s S N N N N N N N N N N N N N N
N N N N N N N N N N N l l l l l l l l l l l L N N N N N N N N N N N N N N N N N N N N N N N N N N N N N N N N N N N N N N N N N N N N N N N N N N N N S s s s s s s S N N N N N N N N N N N N N
N N N N N N N N N N N L L l l l l l l L L L N N N N N N N N N N N N N N N N N N N N N N N N N N N N N N N N N N N N N N N N N N N N N N N N N N N N S s s s s s s s S N N N N N N N N N N N N N
N N N N N N N N N N P N L L L l l L L N N N N N N N N N N N N N N N N N N N N N N N N N N N N N N N N N N N N N N N N N N N N N N N N N N N N N N N S s s s s s s s S N N N N N N N N N N N N N
N N N N N N N N N N N N N N L W W L N N N N N N N N N N N N N N N N N N N N N N N N N N N N N N N N N N N N N N N N N N N N N N N N N N N N N N N N S s s s s s s s S N N N N N N N N N N N N N
N N N N N N N P N N N N N N N W W N N N N N N N N N N N N N N N N N N N N N N N N N N N N N N N N N N N N N N N N N N N N N N N N N N N N N N N N N S s s s s s s s S N N N N N N N N N N N N N
N N N N N N N N N N N N N N N W W N N N N N N N N N N N N N N N N N N N N N N N N N N N N N N N N N N N N N N N N N N N N N N P P N N N N N N N N N S s s s s s s s S N N N N N N N N N N N N N
N N N N N N N N P N N N N N N W W N N N N N N N N N N N N N N N N N N N N N N N N N N N N N N N N N N N N N N N N N N N N N N N N N N N N N N N N N S s s s s s s s S N N N N N N N N N N N N N
N N N N N N N N N N N N N N N W W N N N N N N N N N N N N N N N N N N N N N N N N N N N N N N N N N N N N N N N N N N N P P N N N N N N N N N N N N S s s s s s s s S N N N N N N N N N N N N N
N N N N N N N N N N N P N N N W W N N N N N N N N N N N N N N N N N N N N N N N N L N N N N N N N N N N N N N P P N N N N N N N N N N N N N N N N N S s s s s s s s S N N N N N N N N N N N N N
N N N N N N N N N N N N N N N W W N N N N N N N N N N N N N N N N N N N N N N N L L L N N P P P P P P P P N N N N N N N N N N N N N N N N N N N N S s s s s s s s s s S S S N N N N N N N N N N
N N N N N N N N N N N N N N P W W N N N N N N N N N N N N N N N N N N N N N N N L L L N N N N N P P N N N N N N N N N N N N N N N N N N N N N N N S s s s s s s s s s s s s S S S S N N N N N N
N N N N N N N N N N N N N N N W W N N N N N N N N N N N N N N N N N N N N N N N L L L N N N N N P P N N N N N N N N N N N N N N N N N N N N N N N S s s s s s s s s s s s s s s s s N N N N N N
N N N N N N N N N N N N N N N W W N N N N N N N N N N N N N N N N N S S S N N L L L L L N N N N P P N N N N N N N N N N N N N N N N N N N N N N N S s s s s s s s s s s s s s s s s N N N N N N
N N N N N N N G G G G G G G G D D G G G G G G G G G G N N N N N N S S S S S N N N W N N N N N N P P N N N N N N N N N N N N S S S N N N N N N N S s s s s s s s S S S S S S S S S S G G G G G G
G G G G G G G D d d d d d d d d d d d d d d d d d d D G N N N N N S S S S S S N N W N G G G G G D D G G G G N N N N N N N S S S S S N N N N N N S s s s s S S S N N N N N N N N N N N N N N N N
d d d d d d d d d d d d d d d d d d d d d d d d d d d D G G G G G D D D D D D G G D G D d d d d d d d d d D G G G G G G G D D D D D G G G G G G S s s s s N N N N N N N N N N N N N N N N N N N
d d d d d d d d d d d d d d d d d d d d d d d d d d d d d d d d d d d d d d d d d d d d d d d d d d d d d d d d d d d d d d d d d d d d d d d d d d d d d d d d d d d d d d d d d d d d d d d d
d d d d d d d d d d d d d d d d d d d d d d d d d d d d d d d d d d d d d d d d d d d d d d d d d d d d d d d d d d d d d d d d d d d d d d d d d d d d d d d d d d d d d d d d d d d d d d d d
d d d d d d d d d d d d d d d d d d d d d d d d d d d d d d d d d d d d d d d d d d d d d d d d d d d d d d d d d d d d d d d d d d d d d d d d d d d d d d d d d d d d d d d d d d d d d d d d

