N N N N N N N N N N N N N N N N N N N N N N N N N N N N N N N N N N N N N N N N N N N N N N N N N N N N N N N N N N N N N N N N N N N N N N N N N N N N N N N N N N N N N N N N N N N N N N N N
N N N N N N N N N N N N N N N N N N N N N N N N N N N N N N N N N N N N N N N N N N N N N N N N N N N N N N N N N N N N N N N N N N N N N N N N N N N N N N N N N N N N N N N N N N N N N N N N
N N N N N N N N N N N N N N N N N N N N N N N N N N N N N N N N N N N N N N N N N N N N N N N N N N N N N N N N N N N N N N N P P N N N N N N N N N N N N N N N N N N N N N N N N N N N N N N N
N N N N N N N N N N N N N N N L L L L N N N N N N N N N N N N N N N N N N N N N N N N N N N N N N N N N N N N N N N N N N N N N N N N N N N N N N N N N N N N N N N N N N N N N N N N N N N N N
N N N N N N N N N N N N L L L N N N N L L N N N N N N N N N N N N N N N N N N N N N N N N N N N N N N N N N N N N N N N N N N N N N N N N N N N N N N N N N N N N N N N N N N N N N N N N N N N
N N N N N N N N N N N L N N N N N N N N N L N N N N N N N N N N N N N N N N N N N N N N N N N N N N N N N N N N N N N N N N N N N N N N N N N N N P P N N N N N N N N N N N N N N N N N N N N N
N N N N N N N N N N L N N N N N N N N N N N N N N N N N N N N N N N N N N N N N N N N N N N N N N N N N N N N N N N N N N N N N N N N N N P P N N N N N N S S S S N N N N N N N N N N N N N N N
N N N N N N N N N N N N N N N N N N N N N N N N N N N N N N N N N N N N N N N N N N N N N N N N N N N N N N N N N N N N N N N N N N N N N N N N N N N N S N N N N S N N N N N N N N N N N N N N
N N N N N N N N N N N N N N N N N N N N N N L N N N N N N N N N N N N N N N N N N N N N N N N N N N N N N N N N N N N N N N N N N N N N N N N N N N N S N N N N N N S N N N N N N N N N N N N N
N N N N N N N N N N N L L N N N N N N L L L N N N N N N N N N N N N N N N N N N N N N N N N N N N N N N N N N N N N N N N N N N N N N N N N N N N N S N N N N N N N S N N N N N N N N N N N N N
N N N N N N N N N N P N L L L N N L L N N N N N N N N N N N N N N N N N N N N N N N N N N N N N N N N N N N N N N N N N N N N N N N N N N N N N N N S N N N N N N N S N N N N N N N N N N N N N
N N N N N N N N N N N N N N L W W L N N N N N N N N N N N N N N N N N N N N N N N N N N N N N N N N N N N N N N N N N N N N N N N N N N N N N N N N S N N N N N N N S N N N N N N N N N N N N N
N N N N N N N P N N N N N N N W W N N N N N N N N N N N N N N N N N N N N N N N N N N N N N N N N N N N N N N N N N N N N N N N N N N N N N N N N N S N N N N N N N S N N N N N N N N N N N N N
N N N N N N N N N N N N N N N W W N N N N N N N N N N N N N N N N N N N N N N N N N N N N N N N N N N N N N N N N N N N N N N P P N N N N N N N N N S N N N N N N N S N N N N N N N N N N N N N
N N N N N N N N P N N N N N N W W N N N N N N N N N N N N N N N N N N N N N N N N N N N N N N N N N N N N N N N N N N N N N N N N N N N N N N N N N S N N N N N N N S N N N N N N N N N N N N N
N N N N N N N N N N N N N N N W W N N N N N N N N N N N N N N N N N N N N N N N N N N N N N N N N N N N N N N N N N N N P P N N N N N N N N N N N N S N N N N N N N S N N N N N N N N N N N N N
N N N N N N N N N N N P N N N W W N N N N N N N N N N N N N N N N N N N N N N N N L N N N N N N N N N N N N N P P N N N N N N N N N N N N N N N N N S N N N N N N N S N N N N N N N N N N N N N
N N N N N N N N N N N N N N N W W N N N N N N N N N N N N N N N N N N N N N N N L L L N N P P P P P P P P N N N N N N N N N N N N N N N N N N N N S N N N N N N N N N S S S N N N N N N N N N N
N N N N N N N N N N N N N N P W W N N N N N N N N N N N N N N N N N N N N N N N L L L N N N N N P P N N N N N N N N N N N N N N N N N N N N N N N S N N N N N N N N N N N N S S S S N N N N N N
N N N N N N N N N N N N N N N W W N N N N N N N N N N N N N N N N N N N N N N N L L L N N N N N P P N N N N N N N N N N N N N N N N N N N N N N N S N N N N N N N N N N N N N N N N N N N N N N
N N N N N N N N N N N N N N N W W N N N N N N N N N N N N N N N N N S S S N N L L L L L N N N N P P N N N N N N N N N N N N N N N N N N N N N N N S N N N N N N N N N N N N N N N N N N N N N N
N N N N N N N G G G G G G G G D D G G G G G G G G G G N N N N N N S S S S S N N N W N N N N N N P P N N N N N N N N N N N N S S S N N N N N N N S N N N N N N N S S S S S S S S S S G G G G G G
G G G G G G G D D D D D D D D D D D D D D D D D D D D G N N N N N S S S S S S N N W N G G G G G D D G G G G N N N N N N N S S S S S N N N N N N S N N N N G G G N N N N N N N N N N N N N N N N
D D D D D D D D D D D D D D D D D D D D D D D D D D D D G G G G G D D D D D D G G D G D D D D D D D D D D D G G G G G G G D D D D D G G G G G G D G G G G N N N N N N N N N N N N N N N N N N N